AANCHAL	SHRESTHA
AASHISH	SHRESTHA
AMUL	DHUNGEL
BIVIDH	GHIMIRE
DAVID	GURUNG
DIPESH	SHRESTHA
DIVYA	PANTHI
ELIZA	KARMACHARYA
ISHWOR	PUDASAINI
JAGADISH	PANDEY
KISHOR	KARKI
KSHITIZ MOKTAN	TAMANG
MAHIMA LAXMI	SHAKYA
MELINA	KARKI
MONIK	SHRESTHA
NISHANT	KARKI
PAWAN	BOHARA
PUJAN RAJ	RAI
RAJIV KUMAR	NAYAK
RANJIT	THAPA
SAGARDIP	POUDEL
SARBESH LAL	AMATYA
SHANKALPA	KOIRALA
SONIKA	TIMSINA
SRISHTI	ULAK
SULAV	ADHIKARI
SWAGAT	ADHIKARI
UTSHA	SHRESTHA